1111111111
1E00000001
1000000001
1000000001
10C0000001
1000000001
100000P001
1111111111