1111111111
1E10000001
1000000001
1000000001
1000000001
1000001001
1C1001P101
1111111111