11111111111111111111
1E000000011000000001
10000000000000000001
10000000011000000001
10C00000011000000001
10000010011000000001
100001P0011000000001
11111111111111111111