111111111
1E0000001
111010101
1C001P1C1
111111111