111111111111111
1E0000000000011
111010100000011
1C001P100000011
111111111111111
111111111111111
111111111111111
111111111111111