111111111
1P000E001
111000001
11100C001
1C0000001
111111111